25 25
650 400
8 8 8 8 8 8 8 8 8 8 8 8 8 8 8 8 8 8 8 8 8 8 8 8 8 
8 1 1 1 0 1 5 1 1 0 1 0 1 1 0 0 0 0 0 1 1 0 1 0 8 
8 1 1 1 0 1 4 1 1 0 1 0 1 1 1 1 0 1 0 2 1 0 2 0 8 
8 3 0 1 1 0 5 1 1 1 1 1 1 1 1 0 0 1 0 1 1 0 1 0 8 
8 2 0 1 0 1 5 1 0 1 1 1 0 1 1 0 1 0 0 2 2 2 1 2 8 
8 2 0 1 0 1 4 1 1 0 0 0 1 1 1 0 0 1 1 2 1 2 1 0 8 
8 4 4 1 4 4 4 1 1 1 1 1 1 0 1 1 0 1 0 1 1 0 1 3 8 
8 1 1 1 1 0 1 0 1 1 1 1 1 0 1 0 0 1 1 1 1 0 1 2 8 
8 0 1 0 1 1 1 1 1 0 0 0 1 1 1 0 1 1 0 3 3 3 1 0 8 
8 0 1 1 0 1 1 1 1 1 1 0 1 1 1 0 0 1 1 3 2 3 1 0 8 
8 1 1 0 1 1 1 0 1 0 1 1 0 0 1 1 0 1 1 2 2 3 3 2 8
8 0 1 0 1 0 1 0 1 0 0 1 0 1 1 0 0 1 1 2 1 0 3 2 8 
8 1 0 0 1 0 1 1 2 1 1 1 1 0 1 0 1 1 0 2 3 0 2 2 8 
8 1 0 1 1 1 1 2 2 1 0 0 1 0 0 1 1 0 0 1 1 0 1 0 8 
8 0 1 1 1 1 1 1 2 2 1 0 7 1 1 1 1 1 1 1 1 2 1 0 8 
8 1 1 1 0 1 1 1 2 1 1 6 7 0 0 1 1 1 0 3 1 2 1 0 8 
8 0 1 1 0 1 1 0 0 0 1 6 6 1 0 1 0 0 2 1 2 0 1 0 8 
8 0 1 1 1 1 1 1 1 1 1 1 1 1 1 1 1 2 2 1 2 0 1 0 8 
8 1 1 1 0 0 0 1 1 0 0 1 1 1 1 0 2 2 7 7 6 6 6 6 8 
8 1 1 1 1 1 1 1 1 1 1 1 1 1 1 1 0 1 7 3 2 2 2 3 8 
8 1 0 1 0 1 2 2 1 0 1 0 1 1 0 0 6 2 6 2 2 2 2 3 8 
8 1 1 1 0 1 2 3 1 0 1 0 1 1 1 1 7 3 2 2 3 3 2 3 8 
8 1 0 1 1 0 3 3 1 1 1 1 1 1 1 0 7 3 2 2 3 3 2 3 8 
8 1 0 1 0 1 2 3 0 1 1 1 0 1 1 0 7 2 2 2 2 3 2 3 8 
8 8 8 8 8 8 8 8 8 8 8 8 8 8 8 8 8 8 8 8 8 8 8 8 8 


dirt 				0	Not Solid
grass 				1	Not Solid
stone 				2	Not Solid
moss stone 			3   Not Solid
brick 	 			4	Solid
moss brick			5	Solid
stone brick			6	Solid
moss stone brick	7	Solid
barrier				8 	Solid